|||||||||||||||||||||||||||||||||||
||                               ||
|| ||        |||  ||||||||       ||
|| ||   @    |||            |||||||
|| ||        ||  ||              ||
|||||||||||||||  ||||||||||||||||||
||                               ||
|| ||||||||||||||||||||||||||||| ||
||           ||                  ||
|||||||||||  ||  |||||||         ||
||                    ||         ||
||           ||     ||||      |||||
|||||||||||||||||||||||||||||||||||